********************************************************************************************************************************************\
********************************************************************************************************************************************\
********************************************************************************************************************************************\
********************************************************************************************************************************************\
********************************************************************************************************************************************\
********************************************************************************************************************************************\
********************************************************************************************************************************************\
********************************************************************************************************************************************\
************************************************************************...............*****************************************************\
***********************************************************************................*****************************************************\
***********************************************************************................*****************************************************\
***********************************************************************................*****************************************************\
************************......................................*********................*****************************************************\
***********************.......................................*********................*****************************************************\
***********************.......................................*********...............******************************************************\
***********************.......................................******************************************************************************\
***********************.......................................******************************************************************************\
***********************.......................................******************************************************************************\
***********************.......................................******************************************************************************\
***********************.......................................******************************************************************************\
***********************.......................................**********...............*****************************************************\
***********************.......................................*********................*****************************************************\
***********************.......................................*********................*****************************************************\
***********************.......................................*********................*****************************************************\
***********************.......................................*........................*****************************************************\
***********************...............................................*................*****************************************************\
***********************.......................................*********................*****************************************************\
***********************.......................................*********................*****************************************************\
***********************.......................................*********................*****************************************************\
***********************.......................................*********...............******************************************************\
***********************.......................................*****************.************************************************************\
***********************.......................................****************..************************************************************\
***********************.......................................****************..************************************************************\
***********************.......................................****************..************************************************************\
***********************.......................................****************.*************************************************************\
***********************.......................................**********...............*****************************************************\
***********************.......................................*********................*****************************************************\
***********************.......................................*********................*****************************************************\
***********************.......................................*********................*****************************************************\
***********************......................................**********................*****************************************************\
***********************************************************************................*****************************************************\
***********************************************************************...............******************************************************\
********************************************************************************************************************************************\
********************************************************************************************************************************************\
********************************************************************************************************************************************\
********************************************************************************************************************************************\
********************************************************************************************************************************************\
********************************************************************************************************************************************\
********************************************************************************************************************************************\
********************************************************************************************************************************************\
********************************************************************************************************************************************\
********************************************************************************************************************************************\
********************************************************************************************************************************************\
********************************************************************************************************************************************\
********************************************************************************************************************************************\
********************************************************************************************************************************************\
********************************************************************************************************************************************\
********************************************************************************************************************************************\
********************************************************************************************************************************************\
********************************************************************************************************************************************\
