==========####==============================================================================================================================\
=.........###==========================.......===..................................................===....===....===....===....===....===..=\
=.........###==========================..........=..............................................===###====###====###====###====###====###===\
=.........####=========================...........==...........................................=############################################\
=.........###==========================.............=.........................................=####...####...####...####...####...####...###\
=.........###==========================..............=........................................=##..........................................=\
=.........#####=========================..............=.......................................=##..........................................=\
=..........###==========================..............=......................................=##...........................................=\
=..........###==========================...............=.....................................=##...........................................=\
=..........####=========================................=....................................=##...........................................=\
=..........###===========================...............=.....................................=##..........................................=\
=..........###===========================...............=.....................................=##..........................................=\
=..........####==========================................=....................................=##..........................................=\
=..........###===========================................=....................................=##..........................................=\
=..........###===========================................=...................................=##...........................................=\
=..........####==========================.................=..................................=##...........................................=\
=..........###===========================.................=..................................=##...........................=...=...........=\
=..........###===========================.................=...................................=##...........................###............=\
=..........####==========================.................=...................................=##......=.....=..............###............=\
=..........#####==#==#==#==#=============..................=..................................=##.......#####...............###............=\
=..........##################============..................=..................................=##.......#####..............=...=...........=\
=..........#################=============..................=.................................=##........#####..............................=\
=..........#################=============..................=.................................=##........#####..........=...=...............=\
=..........###...........####============...................=................................=##........#####...........###................=\
=..........###...........###=============...................=.................................=##......=.....=..........###....=...=.......=\
=..........###...........###=============...................=.................................=##.......................###.....###........=\
=..........###...........####===========....................=.................................=##......................=...=....###........=\
=...........#.............#.============....................=.................................=##...............................###........=\
............#.............#.................................=...................................=..............................=...=.......=\
............#.............#.................................=...................................=..........................................=\
............#.............#.................................=...................................=..........................................=\
............#.............#.................................=...................................=..........................................=\
............#.............#.................................=...................................=..........................................=\
=...........#.............#.============....................=.................................=##..........................................=\
=..........###...........####===========....................=.................................=##..........................................=\
=..........###...........###=============...................=.................................=##..........................................=\
=..........###...........###=============...................=.................................=##..........................................=\
=..........###...........####============..................=.................................=##...........................................=\
=..........#################=============..................=.................................=##...........................................=\
=..........#################=============..................=.................................=##...........................................=\
=..........##################============..................=..................................=##..........................................=\
=..........#####==#==#==#==#=============.................=...................................=##..........................................=\
=..........####==========================.................=...................................=##..........................................=\
=..........###===========================.................=...................................=##..........................................=\
=..........###===========================.................=..................................=##...........................................=\
=..........####==========================................=...................................=##...........................................=\
=..........###===========================................=...................................=##...........................................=\
=..........###===========================................=....................................=##..........................................=\
=..........####==========================...............=.....................................=##..........................................=\
=..........###==========================................=.....................................=##..........................................=\
=..........###==========================................=.....................................=##..........................................=\
=..........####=========================...............=.....................................=##...........................................=\
=..........###==========================..............=......................................=##...........................................=\
=.........####=========================...............=......................................=##...........................................=\
=.........#####========================..............=........................................=##..........................................=\
=.........###==========================.............=.........................................=##..........................................=\
=.........###==========================...........==..........................................=####...####...####...####...####...####...###\
=.........####========================...........=.............................................=############################################\
=.........###========================.........===...............................................===###====###====###====###====###====###===\
==========###===============================================================================================================================\
