################################################################################################################============================\
################################################################################################################..........................==\
#################################################################################################################..........................=\
################################################################################################################...........................=\
################################################################################################################........#################..=\
#################################################################################################################.......#...=...=...=...#..=\
################################################################################################################........#...=...=...=...#..=\
=##.......##.......##.......##.......##.......##.......##.......##.......##.......##.......##.......##.......###........#...=...=...=...#..=\
=#..................#.........................#..................#...........................................####.......#...=...=...=...#..=\
=#..................#.........................#..................#...........................................###........#...=...=...=...#..=\
=#..................#.........................#..................#...........................................###........##.###.###.###.##..=\
=#..................#.........................#..................#...........................................####.......=...=...=...=...=..=\
=#..................#.........................#..................#...........................................###...........................=\
=#..................#.........................#..................#...........................................###...........................=\
=#..................#.........................#..................#...........................................####..........................=\
=##.......##.......##.......##.......##.......##.......##.......##.......##.......##.......##.......##.......###...........................=\
###############+###################################+########+###################################################.....==....................=\
###.......##.......##.......##.......##.......##.......##.......##.......##.......##.......##.......##.......####...====...................=\
##............................................................................................................##....====...................=\
##............................................................................................................##.....==....................=\
##............................................................................................................###..........................=\
##............................................................................................................##...........................=\
##............................................................................................................##...........................=\
##............................................................................................................###..........................=\
##............................................................................................................##...........................=\
###.......##.......##.......##.......##.......##.......##.......##.......##.......##.......##.......##.......###...........................=\
###.......##.......##.......##.......##.......##.......##.......##.......##.......##.......##.......##.......####..........................=\
##............................................................................................................#............................=\
##............................................................................................................#............................=\
##............................................................................................................#............................=\
##............................................................................................................#............................=\
##............................................................................................................#............................=\
##............................................................................................................#............................=\
##............................................................................................................#............................=\
###.......##.......##.......##.......##.......##.......##.......##.......##.......##.......##.......##.......####..........................=\
###.......##.......##.......##.......##.......##.......##.......##.......##.......##.......##.......##.......###...........................=\
##............................................................................................................##...........................=\
##............................................................................................................###..........................=\
##............................................................................................................##...........................=\
##............................................................................................................##...........................=\
##............................................................................................................###..........................=\
##............................................................................................................##...........................=\
##............................................................................................................##.......######...##.........=\
###.......##.......##.......##.......##.......##.......##.......##.......##.......##.......##.......##.......####......#...#.....#.........=\
###############+#################+#####################################################+########################.......#...#.....#.........=\
=##.......##.......##.......##.......##.......##.......##.......##.......##.......##.......##.......##.......###.......#...#.....#.........=\
=.........#.........#.......#..................#.........................#...........................#.......####......#...+....=#.........=\
=.........#.........#.......#..................#.........................#...........................#.......###.......#...#...==#.........=\
=.........#.........#.......#..................#.........................#...........................#.......###.......###########.........=\
=.........#.........#.......#..................#.........................#...........................#.......####..........................=\
=.........#.........#.......#..................#.........................#...........................#.......###...........................=\
=.........#.........#.......#..................#.........................#...........................#.......###...........................=\
=.........#.........#.......#..................#.........................#...........................#.......####..........................=\
=##.......##.......##.......##.......##.......##.......##.......##.......##.......##.......##.......##.......###...........................=\
################################################################################################################...........................=\
#################################################################################################################..........................=\
################################################################################################################...........................=\
################################################################################################################...........................=\
#################################################################################################################..........................=\
################################################################################################################============================\
