********************************************************************************************************************************************\
********************************************************************************************************************************************\
********************************************************************************************************************************************\
********************************************************************************************************************************************\
********************************************************************************************************************************************\
********************************************************************************************************************************************\
********************************************************************************************************************************************\
**********************************************************************..................****************************************************\
**********************************************************************..................****************************************************\
**********************************************************************..................****************************************************\
**********************************************************************..................****************************************************\
**********************.........................................*******..................****************************************************\
**********************.........................................*******..................****************************************************\
**********************.........................................*******..................****************************************************\
**********************.........................................*******..................****************************************************\
**********************.........................................*******..................****************************************************\
**********************.........................................**************....***********************************************************\
**********************.........................................**************....***********************************************************\
**********************.........................................**************....***********************************************************\
**********************.........................................*******..................****************************************************\
**********************.........................................*******..................****************************************************\
**********************.........................................*******..................****************************************************\
**********************.........................................*******..................****************************************************\
**********************..................................................................****************************************************\
**********************..................................................................****************************************************\
**********************..................................................................****************************************************\
**********************..................................................................****************************************************\
**********************.........................................*******..................****************************************************\
**********************.........................................*******..................****************************************************\
**********************.........................................*******..................****************************************************\
**********************.........................................*******..................****************************************************\
**********************.........................................**************....***********************************************************\
**********************.........................................**************....***********************************************************\
**********************.........................................**************....***********************************************************\
**********************.........................................*******..................****************************************************\
**********************.........................................*******..................****************************************************\
**********************.........................................*******..................****************************************************\
**********************.........................................*******..................****************************************************\
**********************.........................................*******..................****************************************************\
**********************.........................................*******..................****************************************************\
**********************.........................................*******..................****************************************************\
**********************************************************************..................****************************************************\
**********************************************************************..................****************************************************\
********************************************************************************************************************************************\
********************************************************************************************************************************************\
********************************************************************************************************************************************\
********************************************************************************************************************************************\
********************************************************************************************************************************************\
********************************************************************************************************************************************\
********************************************************************************************************************************************\
********************************************************************************************************************************************\
********************************************************************************************************************************************\
********************************************************************************************************************************************\
********************************************************************************************************************************************\
********************************************************************************************************************************************\
********************************************************************************************************************************************\
********************************************************************************************************************************************\
********************************************************************************************************************************************\
********************************************************************************************************************************************\
********************************************************************************************************************************************\
