°°.....°±.###~~~~~~~~~~~~~~~~~~~~~~~~~........Ï....°..±..±.°......°..°...........°..°±.°°.±....°.°°°........±.°°.........°...°.....°.....±±±\
.....°.°±.###~~~~~~~~~~~~~~~~~~~~~~~~~~..°...°±ÏÏ..±±±..°±.°....±.....±±±...±....°..°........±°.°°.........°...°°.°....±±..±......°....°..°.\
..°°......###~~~~~~~~~~~~~~~~~~~~~~~~~~..°.....°.Ï..±.±°.°..±.°±.±.±.±.°.°..±......°..±°±....°.±°..±°....°±....±..°°..±±.......°..±°±..±.±±±\
°.....°..±###~~~~~~~~~~~~~~~~~~~~~~~~~~...........ÏÏ°°°°..°.±..±±°±±....±.±..±°.......°±...±.±...±...........±..±....±.°.....°°...........°°\
.°..±..°±.###~~~~~~~~~~~~~~~~~~~~~~~~~~..°....±.°.±.Ï±....±.........±°±..°...±.°.........±±.....°..±.±...°±....±.±.±.°±.°.....°±.°±..°..±°..\
±.......°.###~~~~~~~~~~~~~~~~~~~~~~~~~~.....±...±....Ï...±....±°.±°°.±......±...°..±.°....±..±....°°.........±..±±.....°.±±°.°°±........±°°.\
±........°###~~~~~~~~~~~~~~~~~~~~~~~~~~~..°.±.°°±.±..±Ï..........±...°....°.°..°.±.±±.°.°°°........±.°±±..±°.........±......°.°.......±.....\
....°....±.###~~~~~~~~~~~~~~~~~~~~~~~~~~..........±±.±Ï±.°°..±.....±°°..°.......°..°±...±...°.....±.............±..°±.±...±..±.....°..±°.±.°\
°....±.....###~~~~~~~~~~~~~~~~~~~~~~~~~~.±.°...°.°.°±..Ï°.....±±.....±..±°.......±...............±.±.........°.±.±..±°.°°±.±....°..±.°..±...\
....°±°..±.###~~~~~~~~~~~~~~~~~~~~~~~~~~.±..±...±°.....°Ï°..±..°±±.°........±..°°.°±°..........°.°...±..°±..±....±...±±..°...°..°..±±...°...\
±..°.±....°###~~~~~~~~~~~~~~~~~~~~~~~~~~~.°..±°..°±..°.°Ï..±.±..±.......°...±±°±.±......±±°.°...±....±..°.±...°..±°....°.±..°±...±.....°...±\
°..±°..±°..###~~~~~~~~~~~~~~~~~~~~~~~~~~~.....±°°±.±..±.Ï....±.°.°.....°....±.±.°.......°±.°.±.....±°....°...±..±.........±...........±.±.°±\
.°.±.°.....###~~~~~~~~~~~~~~~~~~~~~~~~~~~°....±.±.±°...±.Ï...±....±±±.°±±.±..±°.±±.°..±..°.°....±..°...°.......°°.±.°±..°°..°...°.±.°°...°±±\
..±.°......###~~~~~~~~~~~~~~~~~~~~~~~~~~~.°...±.±±°.°..°.Ï.°±±..°±°°°.±..............±.°...±......°.±..°...°.±....°±±±.±°...°...±°..........\
.°±...°±...###~~~~~~~~~~~~~~~~~~~~~~~~~~~..±..±..°°°...±.Ï....°°±.±°........±..°....±.....±.±±......°.....±±±±..±..±±.°......°..........±...\
....°.±...°###~~~~~~~~~~~~~~~~~~~~~~~~~~~.±.........±.°.°±Ï±...°°°±°....°.°.°.........±.......±°±±....°±°..±..±....°..±.±°.....°.°°°.....°°±\
...........###~~~~~~~~~~~~~~~~~~~~~~~~~~~.°.±±±..°.±....±.Ï.±±...°...°....°...°.±.°±.......°.±°.±°...°...°...±..°°.°....±..........°..°±.°±.\
.°±°°.±.°..###~~~~~~~~~~~~~~~~~~~~~~~~~~~±.°°°±.°....±.±.°Ï.±.°........°.°....°..°.±....±.....°°.±±....°.......±±°..±.°.....°..±.......°.±±.\
.°..°°..°..###~~~~~~~~~~~~~~~~~~~~~~~~~~~±°..±..°.°±±.....Ï°..±...°±°..°.±...±......±..±......±±.±±....±±............±...±.......°...±......\
°°.........###~~~~~~~~~~~~~~~~~~~~~~~~~~~..±.°.°...°......°Ï±°.°±..±°°...°±±.°....°.±......°±...±....°..å°°°è..±.....±..±....±......°.±.°..±\
..°......±.#################~~~~~.~~~~~~~.±±...±°.°.°.±....Ï..±.°±±±.°°..±°............°°±......±±±.±..°°\./....±....°..........±.°....±....\
°.±.°.°.°.°#################~~~~~~~~~~~~~°.°.....°....±°.°±Ï±°..±°.°±°.°..±°±±..±..±.°.±.°.........°.°°.°.ú...±..±..........±.......°.......\
........±°.#################~~~~~~~~~~~~~..±°.°..±±°..°.°..Ï.....°....±±°..°..°...±....±°...°..°..±.....°/.\°°°...±....°..........±°.°±.....\
°..°.......###.±.....±...###~~~~~~~~~~~~~..±...°....±.±.±°.°Ï.±......±°.±....±.°°°.....±.°..°.°........°ã°°°â.°..±°.°°±.°......±....±...±.°.\
°....±..±..###°.°.±°°....###~~~~~~~~~~~~~.°.....°±.±±.°..°.°Ï...°.±°°.......±..°.±.±....±...°°..°.±.±.±°......°.°.°±.°....±°.±.±.°±°°......°\
±.....±.°.±###.°.±°.°°°±.###~~~~~~~~~~~~~.±.°..°°...°°...°..Ï...±°.°±...°......±°.±..±........°...°°..°°°.±..±....°..±.°±..±..°.±°±.°....°.°\
......°±±°.###°...°±°....###~~~~~~~~~~~~..±.°.±±...°..°.....Ï..°......±.°....°...°....°.±°°.±.°..°°.°...°...°....°°...........±.°....°....±±\
......°.±.../ú...±.±±.°.±þ/.~~~~~~~~~~~~...±.±±..±..°...±..°úú..úþ....þ....þ...ú......±±°......°°°.......þ...úú...þ.þ.±±.°.....°..±.±....°±.\
..þþ..þ...úú/þ...ú..ú...../úúúúúúúúúúúúúúú...ú.ú....ú.....þ....þ..þú..þ..ú........þú....ú.þ...úú..þ..þ.ú........þ.....ú.þ.þ..±°..........°°°\
ú..þþ....ú.ú/ú........ú.þú/þúúúúúúúúúúúúú..þúþ..........ú..ú...ú.ú..þ..ú..úþ......þþ.........ú.þúþú.þúþú....þ.ú....úúþ.....þ...þ..þ.þúú.þú..\
.þþ..þ....../......þ.ú...þ/.úúúúúúúúúúúúú.....ú.......þ.þ.......ú.þ...þ....þ..ú.ú.....þþú.þ.þúþ...úú...úþ...ú..úú.....úþúúú.þ.þú.ú..ú..þú..þ\
ú.ú.ú......./..þ..ú...ú.ú./.úúúúúúúúúúúúúþ.úþ....ú....þ.þú...úúúþ...ú..þ..ú...ú...þþ...ú...ú..ú.þ.....þ.þ.þúú.ú..ú....þ.úúþþ..þ.....ú..ú....\
.ú.þ.ú...þþ./úú.ú.ú.....úú/þúúúúúúúúúúúúúú.þ.ú....þþú...ú...Ï..........±..°°.±..±...ú..ú..úþ.....þ.....±.°±..±±......úþþú...ú......þ.þ..ú...\
±°........°./ú.±...±..±±../.~~~~~~~~~~~~.°.±.±°.°.°...±°...±Ï...±....°.±......±°.±±..............±°±..°°.°°...°...°.±°.±..±°......þ...ú...þ.\
.......°...###..°...°±.°.###~~~~~~~~~~~~.°°...°..°°....±°.±°Ï±.°°..°.°....°...°±......±............°±±.....±.°...±...°°..°..°±........°....±\
....±±...±.###....±...±..###~~~~~~~~~~~~~....°.°..±.°.......Ï......°...±°........±.°.±.........°....°±..±°.°.±.........°.±°°±...°±.....°....\
.°±...°±°±±###..±.°..±.±°###~~~~~~~~~~~~~..°.±..±.......°...Ï.....°.....±....±°°.°..±.......°±..±±..±......±...±........±..°°°......±..°....\
.......±.±±###..±......±.###~~~~~~~~~~~~~.....±.°°...±....±Ï.......°°..°...±±±°.........±.°..±.±...°.±..°....°°°±..±.±±±..±...±..°..±.....°°\
.°.°.°..±..#################~~~~~~~~~~~~~....°.±.°..±...±±±Ï..°±..±.±....±±......±.°..±°°..°.....±°.±..°°±...°±..°.........±...±°.°±±....°..\
.±.°.....°°#################~~~~~~~~~~~~~°..±..±..±....±.°.Ï...°°±±.°°....°............°...°°.±°..±.±±..±°±°............±......±.°.±.±..°...\
..±°.°°..±±#################~~~~~~~~~~~~~...±.......°......Ï.......±......°.....±.°.±.°......°±°..±.±...°.....±.±..°°°..°.°..±..±...±...°°±.\
..±....±±.±###~~~~~~~~~~~~~~~~~~~~~~~~~~~..±..°°.°..±±°.°.Ï±±.....±..°.°.°.±....±±...±±°.°...±±....°.°.°.°...°°..±±.°±.±.°....±.°.°...±..°..\
.°..°±..°..###~~~~~~~~~~~~~~~~~~~~~~~~~~~..............±°.Ï°°...°±°.°.±.±...°..........±..°..±±°....°±...±..±.±.......°...°.........±....±..\
.....±±...±###~~~~~~~~~~~~~~~~~~~~~~~~~~~......±±...±..±±°Ï°°.....°.±°..°.±°.°°.°....±°°±.°±±.°°±..°...°°°....±..°±±....°.°±.....±.....°.±..\
...±.°....°###~~~~~~~~~~~~~~~~~~~~~~~~~~~..±....±.°....°°.Ï..°..°±.±°......±°.........±...±°°±.°°±±..±...°±......±..°°.......°±°.±.........±\
°°°.±......###~~~~~~~~~~~~~~~~~~~~~~~~~~~±°°..±.±.°±°.°.±Ï.°.±.±..°...°.±°...±°...°.°±..°...°±....°.....°..±......°..±.±.±°.......±±.±±±.°..\
.±.±..°.°..###~~~~~~~~~~~~~~~~~~~~~~~~~~~°.....±°°.......Ï°±...±°.°°.±....±.°......°°°°°.....°.°...°.±±....°.±±.±.......°.°....°..±...±..±.°\
°...°.±.±..###~~~~~~~~~~~~~~~~~~~~~~~~~~~..±.±..±....°°..Ï±°.°.±..°..°..±°...±.°.........±..±.±±.°.±...°.±.....±°°....±...±.±°...°..±°..°..±\
.°...±.±...###~~~~~~~~~~~~~~~~~~~~~~~~~~~....±°°...±....Ï....°...±......°°.±±.....±..°...°..±..±..°±....±...°±.......±....°.°.°°....°±±.±..°\
±..°.......###~~~~~~~~~~~~~~~~~~~~~~~~~~..±°...±.±±..±..Ï....°±±±...±°.°°°.°.±°°.±°±..±.°....°..±....±±±±.°±°.±±°°°.±.....°.°±.±°.°..±.°.°..\
....°.±....###~~~~~~~~~~~~~~~~~~~~~~~~~~......°...±°...±Ï°.....°....°°°.°°..±..°.°.°.......±..±°..±.°±....°±...±°°..±...±±°......±±.°..°.°..\
.°....°.±°.###~~~~~~~~~~~~~~~~~~~~~~~~~~...°..±..±.....Ï±....±..±........±.°..±.±.±±....°.°±.....±.±±°°°..±.±.±±........°...............±°..\
.°...±..±.±###~~~~~~~~~~~~~~~~~~~~~~~~~~.°°....±...°±.Ï...±±......±.....°...°.±........°......°...±°......±..°°....±...°°±.°.±±...±±..±.....\
...±..±...###~~~~~~~~~~~~~~~~~~~~~~~~~~....°.°°..°....Ï..°°.......°.±±±.±..°±.°±..°......°...°±±..°±....°±..±.°....°..°..±°..°...±..±.±.°.±.\
......±.±.###~~~~~~~~~~~~~~~~~~~~~~~~~~.......°...°.±Ï°°..°...°±........±.±..±.°.±°...±°±...±........±..°±..°.°...±.±.±±.±°....°.°.±..°.....\
.±.±..±..±###~~~~~~~~~~~~~~~~~~~~~~~~~~..±.°..±.°°.°Ï±±.±...±.°.°°.°°......°...°±......°......±...............°......°.°..°.°±..°.±°..°.....\
±.±°.±..±.###~~~~~~~~~~~~~~~~~~~~~~~~~~....°±....±ÏÏ±.°.±.°±...±.°±±°....°.±±°±..±°.±.........°...°±..°.°°±°..±...°..±...°.....±..°±°.±.±...\
°°.±.....°###~~~~~~~~~~~~~~~~~~~~~~~~~...°.......Ï°....±±°...±°±±±.....±±.°±.°.°.......±.°°.....±°.°±.±.±±°..°.°..±....±..±°..°..°...°...°..\
°...±.±...###~~~~~~~~~~~~~~~~~~~~~~~~..........ÏÏ°±...±±±°±.....±±....±....±°......°±±.±.±.±.°±°..±±°±°.°±.±....°...±...°......°.±±°±...±±.°\
..........###~~~~~~~~~~~~~~~~~~~~~~~~....±±.±.Ï.°±.°.°..°.±±...±..°±..±.........°.........±°...°....±°..°..°.±....°..°±..±....°°..±.±±°.°±..\
