###################################################################.............================.===========================================\
###################################################################.............================.===========================================\
####################################################################............================.===========================================\
###################################################################.............================.===========================================\
###################################################################.............=================.==========================================\
####################################################################.............================.==========================================\
###################################################################..............================.==========================================\
###.......##.......##.......##.......##.......##.......##.......###..............================.==========================================\
##...............................................................###.............================.==========================================\
##...............................................................#...............================.==========================================\
##...............................................................=...............================.==========================================\
##...............................................................=...............================.==========================================\
##...............................................................=................================.=========================================\
##...............................................................#................================.=========================================\
##...............................................................##...............================.=========================================\
###.......##.......##.......##.......##.......##.......##.......###...............================.=========================================\
###################################################+###############...............================.=========================================\
###.......##.......##.......##.......##.......##.......##.......###...............================.=========================================\
##...............................................................##...............================.=========================================\
##...............................................................#................================.=========================================\
##...............................................................=................================.=========================================\
##...............................................................=................================.=========================================\
##...............................................................=.................================.========================================\
##...............................................................#.................================.========================================\
##...............................................................##................===#####========.========================================\
###.......##.......##.......##.......##.......##.......##.......###................===#####========.========================================\
###.......##.......##.......##.......##.......##.......##.......###................===#####========.========================================\
##...............................................................##................===#####========.========================================\
##...............................................................#.................================...======================================\
##...............................................................=.................================...======================================\
##...............................................................=....................................##...==...=........===================\
##...............................................................=.................================...======================================\
##...............................................................#.................======.=========...======================================\
##...............................................................##................====....========.========================================\
###.......##.......##.......##.......##.......##.......##.......###................====....========.========================================\
###.......##.......##.......##.......##.......##.......##.......###................====....========.========================================\
##...............................................................##................================.========================================\
##...............................................................#.................================.========================================\
##...............................................................=.................================.========================================\
##...............................................................=................================.=========================================\
##...............................................................=................================.=========================================\
##...............................................................#................================.=========================================\
##...............................................................##...............================.=========================================\
###.......##...........................................##.......###...............================.=========================================\
#############......##.......##.......##.......##......#############...............================.=========================================\
###.......##.......##.......##.......##.......##.......##.......###...............================.=========================================\
##...............................................................##...............================.=========================================\
##...............................................................#................================.=========================================\
##...............................................................=................================.=========================================\
##...............................................................=...............================.==========================================\
##...............................................................=...............================.==========================================\
##...............................................................#...............================.==========================================\
##...............................................................###.............================.==========================================\
###.............................................................###..............================.==========================================\
############.......##.........................##.......############..............================.==========================================\
############################...........#############################.............================.==========================================\
##############################.......##############################..............================.==========================================\
################################.=.################################.............================.===========================================\
################################...#################################............================.===========================================\
###################################################################.............================.===========================================\
