###################################################################.............................................============================\
###################################################################.............................................============================\
####################################################################.............................................===========================\
###################################################################.............................................============================\
###################################################################.............................................========#################===\
####################################################################.............................................=======#################===\
###################################################################.............................................========#################===\
###.......##.......##.......##.......##.......##.......##.......###.............................................========#################===\
##...............................................................###.............................................=======#################===\
##...............................................................#..............................................========#################===\
##...............................................................=..............................................========#################===\
##...............................................................=...............................................=======#################===\
##...............................................................=..............................................=========.==...=..===.=.====\
##...............................................................#..............................................=============.======.=======\
##...............................................................##..............................................===========================\
###.......##.......##.......##.......##.......##.......##.......###.............................................============================\
###################################################+###############.............................................=====..=====================\
###.......##.......##.......##.......##.......##.......##.......###..............................................===.==.====================\
#................................................................##.............................................====.==.====================\
#................................................................#..............................................=====..=====================\
#................................................................=...............................................===========================\
#................................................................=..............................................============================\
#................................................................=..............................................============================\
#................................................................#...............................................===========================\
#................................................................##.............................................============================\
##........##.......##.......##.......##.......##.......##.......###.............................................============================\
##........##.......##.......##.......##.......##.......##.......###..............................................===========================\
#................................................................##.............................................============================\
#................................................................#..........................................................................\
#................................................................=..........................................................................\
#................................................................=..........................................................................\
#................................................................=..........................................................................\
#................................................................#..........................................................................\
#................................................................##.............................................============================\
##........##.......##.......##.......##.......##.......##.......###..............................................===========================\
##........##.......##.......##.......##.......##.......##.......###.............................................============================\
#................................................................##.............................................============================\
#................................................................#...............................................===========================\
#................................................................=..............................................============================\
#................................................................=..............................................==============.=============\
#................................................................=...............................................============..=============\
#................................................................#..............................................=============...============\
#................................................................##.............................................=======...........==========\
##..............................................................###..............................................======...........==========\
##..............................................................###.............................................=======...........==========\
##..............................................................###.............................................=======...........==========\
#................................................................##..............................................======...........==========\
#................................................................#..............................................=======...........==========\
#................................................................=..............................................=======...........==========\
#................................................................=...............................................===========================\
#................................................................=..............................................============================\
#................................................................#..............................................============================\
#................................................................###.............................................===========================\
##..............................................................###.............................................============================\
###################################################################.............................................============================\
####################################################################.............................................===========================\
###################################################################.............................................============================\
###################################################################.............................................============================\
####################################################################.............................................===========================\
###################################################################.............................................============================\
