******************************************************************...................................................***********************\
******************************************************************...................................................***********************\
******************************************************************...................................................***********************\
******************************************************************...................................................***********************\
******************************************************************....................................................**********************\
******************************************************************....................................................**********************\
******************************************************************....................................................**********************\
******************************************************************....................................................**********************\
*****************************************************************.....................................................**********************\
*****************************************************************.....................................................**********************\
*****************************************************************.....................................................**********************\
*****************************************************************.....................................................**********************\
*****************************************************************......................................................*********************\
*****************************************************************......................................................*********************\
*****************************************************************......................................................*********************\
******************************************************************.....................................................*********************\
******************************************************************.....................................................*********************\
******************************************************************.....................................................*********************\
*****************************************************************......................................................*********************\
*****************************************************************......................................................*********************\
*****************************************************************......................................................*********************\
*****************************************************************......................................................*********************\
*****************************************************************.......................................................********************\
*****************************************************************.......................................................********************\
*****************************************************************.......................................................********************\
******************************************************************......................................................********************\
******************************************************************......................................................********************\
*****************************************************************.......................................................********************\
*****************************************************************.......................................................********************\
*****************************************************************.......................................................********************\
*****************************************************************.......................................................********************\
*****************************************************************.......................................................********************\
*****************************************************************.......................................................********************\
*****************************************************************.......................................................********************\
******************************************************************......................................................********************\
******************************************************************......................................................********************\
*****************************************************************.......................................................********************\
*****************************************************************.......................................................********************\
*****************************************************************.......................................................********************\
*****************************************************************......................................................*********************\
*****************************************************************......................................................*********************\
*****************************************************************......................................................*********************\
*****************************************************************......................................................*********************\
******************************************************************.....................................................*********************\
******************************************************************.....................................................*********************\
******************************************************************.....................................................*********************\
*****************************************************************......................................................*********************\
*****************************************************************......................................................*********************\
*****************************************************************......................................................*********************\
*****************************************************************.....................................................**********************\
*****************************************************************.....................................................**********************\
*****************************************************************.....................................................**********************\
*****************************************************************.....................................................**********************\
******************************************************************....................................................**********************\
******************************************************************....................................................**********************\
******************************************************************....................................................**********************\
******************************************************************....................................................**********************\
******************************************************************...................................................***********************\
******************************************************************...................................................***********************\
******************************************************************...................................................***********************\
