******************************************************************..........................................................................\
******************************************************************..........................................................................\
******************************************************************..........................................................................\
******************************************************************..........................................................................\
******************************************************************..........................................................................\
******************************************************************..........................................................................\
****************************************************************............................................................................\
*****************************************************************...........................................................................\
*****************************************************************...........................................................................\
*****************************************************************...........................................................................\
*****************************************************************...........................................................................\
*****************************************************************...........................................................................\
*****************************************************************...........................................................................\
*****************************************************************...........................................................................\
*****************************************************************...........................................................................\
******************************************************************..........................................................................\
******************************************************************..........................................................................\
******************************************************************..........................................................................\
*****************************************************************...........................................................................\
*****************************************************************...........................................................................\
*****************************************************************...........................................................................\
*****************************************************************...........................................................................\
*****************************************************************...........................................................................\
*****************************************************************...........................................................................\
*****************************************************************...........................................................................\
******************************************************************..........................................................................\
******************************************************************..........................................................................\
*****************************************************************...........................................................................\
*****************************************************************...........................................................................\
*****************************************************************...........................................................................\
*****************************************************************...........................................................................\
*****************************************************************...........................................................................\
*****************************************************************...........................................................................\
*****************************************************************...........................................................................\
******************************************************************..........................................................................\
******************************************************************..........................................................................\
*****************************************************************...........................................................................\
*****************************************************************...........................................................................\
*****************************************************************...........................................................................\
*****************************************************************...........................................................................\
*****************************************************************...........................................................................\
*****************************************************************...........................................................................\
*****************************************************************...........................................................................\
******************************************************************..........................................................................\
******************************************************************..........................................................................\
******************************************************************..........................................................................\
*****************************************************************...........................................................................\
*****************************************************************...........................................................................\
*****************************************************************...........................................................................\
*****************************************************************...........................................................................\
*****************************************************************...........................................................................\
*****************************************************************...........................................................................\
*****************************************************************...........................................................................\
******************************************************************..........................................................................\
******************************************************************..........................................................................\
******************************************************************..........................................................................\
******************************************************************..........................................................................\
******************************************************************..........................................................................\
******************************************************************..........................................................................\
******************************************************************..........................................................................\
