###################################################################.............................................============================\
###################################################################.............................................============================\
####################################################################.............................................===========================\
###################################################################.............................................============================\
###################################################################.............................................========#################===\
####################################################################.............................................=======#################===\
###################################################################.............................................========#################===\
###.......##.......##.......##.......##.......##.......##.......###.............................................========#################===\
##...............................................................###.............................................=======#################===\
##...............................................................#..............................................========#################===\
##...............................................................=..............................................========#################===\
##...............................................................=...............................................=======#################===\
##...............................................................=..............................................=========.==...=..===.=.====\
##...............................................................#..............................................=============.======.=======\
##...............................................................##..............................................===========================\
###.......##.......##.......##.......##.......##.......##.......###.............................................============================\
###################################################+###############.............................................=====..=====================\
###.......##.......##.......##.......##.......##.......##.......###..............................................===.==.====================\
##...............................................................##.............................................====.==.====================\
##...............................................................#..............................................=====..=====================\
##...............................................................=...............................................===========================\
##...............................................................=..............................................============================\
##...............................................................=..............................................============================\
##...............................................................#...............................................===========================\
##...............................................................##.............................................============================\
###.......##.......##.......##.......##.......##.......##.......###.............................................============================\
###.......##.......##.......##.......##.......##.......##.......###..............................................===========================\
##...............................................................##.............................................============================\
##...............................................................#..........................................................................\
##...............................................................=..........................................................................\
##...............................................................=..........................................................................\
##...............................................................=..........................................................................\
##...............................................................#..........................................................................\
##...............................................................##.............................................============================\
###.......##.......##.......##.......##.......##.......##.......###..............................................===========================\
###.......##.......##.......##.......##.......##.......##.......###.............................................============================\
##...............................................................##.............................................============================\
##...............................................................#...............................................===========================\
##...............................................................=..............................................============================\
##...............................................................=..............................................==============.=============\
##...............................................................=...............................................============..=============\
##...............................................................#..............................................=============...============\
##...............................................................##.............................................=======...........==========\
###.......##...........................................##.......###..............................................======...........==========\
#############......##.......##.......##.......##......#############.............................................=======...........==========\
###.......##.......##.......##.......##.......##.......##.......###.............................................=======...........==========\
##...............................................................##..............................................======...........==========\
##...............................................................#..............................................=======...........==========\
##...............................................................=..............................................=======...........==========\
##...............................................................=...............................................===========================\
##...............................................................=..............................................============================\
##...............................................................#..............................................============================\
##...............................................................###.............................................===========================\
###.............................................................###.............................................============================\
############.......##.........................##.......############.............................................============================\
############################...........#############################.............................................===========================\
##############################.......##############################.............................................============================\
################################.=.################################.............................................============================\
################################...#################################.............................................===========================\
###################################################################.............................................============================\
