################################################################################################################============================\
################################################################################################################..........................==\
#################################################################################################################..........................=\
################################################################################################################...........................=\
################################################################################################################........#################..=\
#################################################################################################################.......#...=...=...=...#..=\
################################################################################################################........#...=...=...=...#..=\
=##.......##.......##.......##.......##.......##.......##.......##.......##.......##.......##.......##.......###........#...=...=...=...#..=\
=............................................................................................................####.......#...=...=...=...#..=\
=............................................................................................................###........#...=...=...=...#..=\
=............................................................................................................###........##.###.###.###.##..=\
=............................................................................................................####.......=...=...=...=...=..=\
=............................................................................................................###...........................=\
=............................................................................................................###...........................=\
=............................................................................................................####..........................=\
=##.......##.......##.......##.......##.......##.......##.......##.......##.......##.......##.......##.......###...........................=\
################################################################################################################...........................=\
=##.......##.......##.......##.......##.......##.......##.......##.......##.......##.......##.......##.......####..........................=\
=.............................................................................................................##...........................=\
=.............................................................................................................##...........................=\
=.............................................................................................................###..........................=\
=.............................................................................................................##...........................=\
=.............................................................................................................##...........................=\
=.............................................................................................................###..........................=\
=.............................................................................................................##...........................=\
=##.......##.......##.......##.......##.......##.......##.......##.......##.......##.......##.......##.......###...........................=\
=##.......##.......##.......##.......##.......##.......##.......##.......##.......##.......##.......##.......####..........................=\
=.............................................................................................................#............................=\
=.............................................................................................................#............................=\
=.............................................................................................................#............................=\
=.............................................................................................................#............................=\
=.............................................................................................................#............................=\
=.............................................................................................................#............................=\
=.............................................................................................................#............................=\
=##.......##.......##.......##.......##.......##.......##.......##.......##.......##.......##.......##.......####..........................=\
=##.......##.......##.......##.......##.......##.......##.......##.......##.......##.......##.......##.......###...........................=\
=.............................................................................................................##...........................=\
=.............................................................................................................###..........................=\
=.............................................................................................................##...........................=\
=.............................................................................................................##...........................=\
=.............................................................................................................###..........................=\
=.............................................................................................................##...........................=\
=.............................................................................................................##...........................=\
=##.......##.......##.......##.......##.......##.......##.......##.......##.......##.......##.......##.......####..........................=\
################################################################################################################...........................=\
=##.......##.......##.......##.......##.......##.......##.......##.......##.......##.......##.......##.......###...........................=\
=............................................................................................................####..........................=\
=............................................................................................................###...........................=\
=............................................................................................................###...........................=\
=............................................................................................................####..........................=\
=............................................................................................................###...........................=\
=............................................................................................................###...........................=\
=............................................................................................................####..........................=\
=##.......##.......##.......##.......##.......##.......##.......##.......##.......##.......##.......##.......###...........................=\
################################################################################################################...........................=\
#################################################################################################################..........................=\
################################################################################################################...........................=\
################################################################################################################...........................=\
#################################################################################################################..........................=\
################################################################################################################============================\
