.============================================================================================================###============================\
.............................................................................................................###..........................==\
=............................................................................................................####..........................=\
=............................................................................................................###...........................=\
=............................................................................................................###...........................=\
=............................................................................................................####..........................=\
################################################################################################################...........................=\
=##.......##.......##.......##.......##.......##.......##.......##.......##.......##.......##.......##.......###...........................=\
=............................................................................................................####..........................=\
=............................................................................................................###...........................=\
=............................................................................................................###...........................=\
=............................................................................................................####..........................=\
=............................................................................................................###...........................=\
=............................................................................................................###...........................=\
=............................................................................................................####..........................=\
=##.......##.......##.......##.......##.......##.......##.......##.......##.......##.......##.......##.......###...........................=\
################################################################################################################...........................=\
=##.......##.......##.......##.......##.......##.......##.......##.......##.......##.......##.......##.......####..........................=\
=............................................................................................................###...........................=\
=.............................................................................................................##...........................=\
=.............................................................................................................###..........................=\
=.............................................................................................................##...........................=\
=.............................................................................................................##...........................=\
=.............................................................................................................###..........................=\
=.............................................................................................................##...........................=\
=##.......##.......##.......##.......##.......##.......##.......##.......##.......##.......##.......##.......###...........................=\
=##.......##.......##.......##.......##.......##.......##.......##.......##.......##.......##.......##.......####..........................=\
=.............................................................................................................#............................=\
=.............................................................................................................#............................=\
=.............................................................................................................#............................=\
=.............................................................................................................#............................=\
=.............................................................................................................#............................=\
=.............................................................................................................#............................=\
=.............................................................................................................#............................=\
=##.......##.......##.......##.......##.......##.......##.......##.......##.......##.......##.......##.......####..........................=\
=##.......##.......##.......##.......##.......##.......##.......##.......##.......##.......##.......##.......###...........................=\
=.............................................................................................................##...........................=\
=.............................................................................................................###..........................=\
=.............................................................................................................##...........................=\
=.............................................................................................................##...........................=\
=.............................................................................................................###..........................=\
=.............................................................................................................##...........................=\
=.............................................................................................................##...........................=\
=##.......##.......##.......##.......##.......##.......##.......##.......##.......##.......##.......##.......####..........................=\
################################################################################################################...........................=\
=##.......##.......##.......##.......##.......##.......##.......##.......##.......##.......##.......##.......###...........................=\
=............................................................................................................####..........................=\
=............................................................................................................###...........................=\
=............................................................................................................###...........................=\
=............................................................................................................####..........................=\
=............................................................................................................###...........................=\
=............................................................................................................###...........................=\
=............................................................................................................####..........................=\
=##.......##.......##.......##.......##.......##.......##.......##.......##.......##.......##.......##.......###...........................=\
################################################################################################################...........................=\
=............................................................................................................####..........................=\
=............................................................................................................###...........................=\
=............................................................................................................###...........................=\
=............................................................................................................####..........................=\
=============================================================================================================###============================\
