***************************************************************************************************************.............................\
***************************************************************************************************************.............................\
***************************************************************************************************************.............................\
***************************************************************************************************************.............................\
***************************************************************************************************************.............................\
***************************************************************************************************************..........***************....\
***************************************************************************************************************..........***************....\
***************************************************************************************************************..........***************....\
***************************************************************************************************************..........***************....\
***************************************************************************************************************..........***************....\
***************************************************************************************************************.............................\
***************************************************************************************************************.............................\
***************************************************************************************************************.............................\
***************************************************************************************************************.............................\
***************************************************************************************************************.............................\
***************************************************************************************************************.............................\
***************************************************************************************************************.............................\
***************************************************************************************************************.............................\
***************************************************************************************************************.............................\
***************************************************************************************************************.............................\
***************************************************************************************************************.............................\
***************************************************************************************************************.............................\
***************************************************************************************************************.............................\
***************************************************************************************************************.............................\
***************************************************************************************************************.............................\
***************************************************************************************************************.............................\
**************************************************************************************************************..............................\
**************************************************************************************************************..............................\
**************************************************************************************************************..............................\
**************************************************************************************************************..............................\
**************************************************************************************************************..............................\
**************************************************************************************************************..............................\
**************************************************************************************************************..............................\
**************************************************************************************************************..............................\
**************************************************************************************************************..............................\
***************************************************************************************************************.............................\
***************************************************************************************************************.............................\
***************************************************************************************************************.............................\
***************************************************************************************************************.............................\
***************************************************************************************************************.............................\
***************************************************************************************************************.............................\
***************************************************************************************************************.............................\
***************************************************************************************************************.............................\
***************************************************************************************************************.............................\
***************************************************************************************************************.............................\
***************************************************************************************************************.............................\
***************************************************************************************************************.............................\
***************************************************************************************************************.............................\
***************************************************************************************************************.............................\
***************************************************************************************************************.............................\
***************************************************************************************************************.............................\
***************************************************************************************************************.............................\
***************************************************************************************************************.............................\
***************************************************************************************************************.............................\
***************************************************************************************************************.............................\
***************************************************************************************************************.............................\
***************************************************************************************************************.............................\
***************************************************************************************************************.............................\
***************************************************************************************************************.............................\
***************************************************************************************************************.............................\
