############################################################################################################################################\
#######################################################################################################################.........############\
#######################################################################################################################..W.I.N......########\
#######################################################################################################################.........###.########\
###################################################################################################################################.########\
###################################################################################################################################.########\
###############################################################################################..#................#.................########\
###############################################################################################.####..########.####.#################......#\
#################.........................#############################................########.##.#..#......#...##.#......#.#######..####.#\
#################.........................#############################..#####..#####..########.##.#..########.####.########......##.#####.#\
#################.........................#############################..#..........#..########.##.#..#...........#..........####.##.#####.#\
#################...###################...#############################..#..........#..########.##.#..#.###########.########.#....##.#####.#\
#################...###.......................................#########..############..########.##.#..#.#......#...........#.#.....#..####.#\
#################...###.......................................#########................########.##.####.#.##.#.##########..#.#.###########.#\
#################...###.......................................#########................########.##......#..#.#.#........#..#.#..#...######.#\
#################...###.......................................################..###############.##.#########.#.#.#.####.#..#.######......#.#\
#################...###.......................................################..###############.##.#.........#.#.#.#..#.#..#....#.#.####.#.#\
#################...###.......................................################..###############.##.#.......#.#.#.#.#..#.#######.#.#.####.#.#\
#################...###.......................................################..###############.##.#########.###.#.#..........#.#.#.####.#.#\
#################...###.......................................################..###############.##...............#.#####.###..#.#.#.####.#.#\
#################...###.......................................#########................########.##.#########.###.#.....#.######.###.####.#.#\
#################...###.......................................#########..#..........#..########.##.######......#.#.###.#.#......#...####.#.#\
#################...###.......................................#########................########.##.............#.#...###.#.######.######.#.#\
#################...###.......................................#########.......##.......########.##.###########.#.###.#.###.######....###.#.#\
#################...###.......................................................##.......#........##.#######...#.#.##..#.....#....#.#..###.#.#\
#################...###................................................................#.................#...#.#.##.##.###.####.#.#..###.#.#\
#################...###.......................................#########................########.########.#...#.#.#...#..##.#..#.#.######.#.#\
#################...###.......................................#########..#..........#..########.########.#######.#.###.###.#..#.#....###.#.#\
#################...###.......................................#########................########........#.........#.#...###.#....#.######.#.#\
#################...###.......................................#########................########.######.#.......#.#.#...#...#..#.#.#..###.#.#\
#################...###.......................................################..###############.##.....#.#####.#.#.###.########.###..###.#.#\
#################...###.......................................################..########################.#...#.#.#...#...#.#..#.#.#..###.#.#\
#################.............................................################..#........................#...#.#.#.###.###.#..#.#.#..###.#.#\
#################.............................................################..########################.#...#.#.#...#.#...##.#.#.#..###.#.#\
#################.............................................################..#############..........#.#...#.#.#..##.###....#.#.#..###.#.#\
#################...###.......................................#########................######.#.###.#..#.#.###.#.#####...#.#..#.#.##.###.#.#\
#################...###.......................................#########................######.#...#.#..###.....#.#...#...#.####....#.###.#.#\
#################...###.......................................#########................##.....#.###.####.#.#####.#.#.#...#......##.#.###.#.#\
#################...###.......................................#########................##.#####.#........#.....#.#.#.#...#.####.##.#.###.#.#\
#################...###.......................................#########................##.#####.#.######.#######.#.#.#.###.#.##.##.#.###.#.#\
#################...########....#######################################................##.#####.#.#..............#.#.#.....#.##.##.#.###.#.#\
#################...########...########################################................##.#####.#.#..#############.#.#.#####.##.##.#.###.#.#\
#################...########...###########################............###################.#####.#.#..###############.#.#........##...###.#.#\
#################...#########..###########################.######.####.#####.############.#####.###..................#.#.######.##...###...#\
#################...##########.###########################.######.####.#####..............#####.#.########################.####.########.###\
##########################################################.#......####.......#####.########.....#.########################.####.########.###\
##########################################################.#.####.##############.........##.###.#............................##.###......###\
##########################################################.#.##......###########.#######.##.#####.#############.##########.####.###.####.###\
##########################################################.#.####.##.###########.#######.##....##.#.............##............#.###.##.#.###\
##########################################################.#......##.............#######.#####....#.###.####.#####.##.####.####.###....#.###\
##########################################################.###.#####.###########.#######.#####.##.#####.##########.############.########.###\
##########################################################.###.......###########.#############.##...............#...............########.###\
##########################################################.#####################.#############.#########################################.###\
##########################################################.......................#..............................#........................###\
###########################################################################################.###################.####.#######################\
###########################################################################################.###################.####.#######################\
###########################################################################################......##############.####.#######################\
###############################################################################################################......#######################\
############################################################################################################################################\
############################################################################################################################################\
