************................................................................................................................................\
************................................................................................................................................\
************................................................................................................................................\
************................................................................................................................................\
************................................................................................................................................\
************................................................................................................................................\
************................................................................................................................................\
************................................................................................................................................\
*************...............................................................................................................................\
*************...............................................................................................................................\
*************...............................................................................................................................\
*************...............................................................................................................................\
*************...............................................................................................................................\
*************...............................................................................................................................\
*************...............................................................................................................................\
*************...............................................................................................................................\
*************...............................................................................................................................\
*************...............................................................................................................................\
*************...............................................................................................................................\
*************...............................................................................................................................\
*************...............................................................................................................................\
***************************.................................................................................................................\
***************************.................................................................................................................\
***************************.................................................................................................................\
***************************.................................................................................................................\
***************************.................................................................................................................\
**************************..................................................................................................................\
**************************..................................................................................................................\
**************************..................................................................................................................\
**************************..................................................................................................................\
**************************..................................................................................................................\
**************************..................................................................................................................\
**************************..................................................................................................................\
**************************..................................................................................................................\
**************************..................................................................................................................\
***************************.................................................................................................................\
***************************.................................................................................................................\
***************************.................................................................................................................\
***************************.................................................................................................................\
***************************.................................................................................................................\
*************...............................................................................................................................\
*************...............................................................................................................................\
*************...............................................................................................................................\
*************...............................................................................................................................\
*************...............................................................................................................................\
*************...............................................................................................................................\
*************...............................................................................................................................\
*************...............................................................................................................................\
*************...............................................................................................................................\
*************...............................................................................................................................\
*************...............................................................................................................................\
*************...............................................................................................................................\
************................................................................................................................................\
************................................................................................................................................\
************................................................................................................................................\
************................................................................................................................................\
************................................................................................................................................\
************................................................................................................................................\
************................................................................................................................................\
************................................................................................................................................\
