==========###===============================================================================================================================\
=.........###==========================........==..........................................................................................=\
=.........###==========================..........=.........................................................................................=\
=.........###==========================...........==.......................................................................................=\
=.........###==========================.............=......................................................................................=\
=.........###==========================..............=.....................................................................................=\
=.........###===========================..............=....................................................................................=\
=..........###==========================..............=....................................................................................=\
=..........###==========================...............=...................................................................................=\
=..........###==========================................=..................................................................................=\
=..........###===========================...............=..................................................................................=\
=..........###===========================...............=..................................................................................=\
=..........###===========================................=.................................................................................=\
=..........###===========================................=.................................................................................=\
=..........###===========================................=.................................................................................=\
=..........###===========================.................=................................................................................=\
=..........###===========================.................=................................................................................=\
=..........###===========================.................=................................................................................=\
=..........###===========================.................=................................................................................=\
=..........###===========================..................=............................................=...=..............................=\
=..........#################=============..................=.............................................###...............................=\
=..........#################=============..................=.............................................###...............................=\
=..........#################=============..................=.............................................###...............................=\
=..........###...........###=============...................=...........................................=...=..............................=\
=..........###...........###=============...................=..................................................................=...=.......=\
=..........###...........###=============...................=...................................................................###........=\
=..........###...........###============....................=...................................................................###........=\
=...........#.............#.============........................................................................................###........=\
............#.............#....................................................................................................=...=.......=\
............#.............#................................................................................................................=\
............#.............#................................................................................................................=\
............#.............#................................................................................................................=\
............#.............#.................................=..............................................................................=\
=...........#.............#.============....................=..............................................................................=\
=..........###...........###============....................=..............................................................................=\
=..........###...........###=============...................=..............................................................................=\
=..........###...........###=============...................=..............................................................................=\
=..........###...........###=============..................=...............................................................................=\
=..........#################=============..................=...............................................................................=\
=..........#################=============..................=...............................................................................=\
=..........#################=============..................=...............................................................................=\
=..........###===========================.................=................................................................................=\
=..........###===========================.................=................................................................................=\
=..........###===========================.................=................................................................................=\
=..........###===========================.................=................................................................................=\
=..........###===========================................=.................................................................................=\
=..........###===========================................=.................................................................................=\
=..........###===========================................=.................................................................................=\
=..........###===========================...............=..................................................................................=\
=..........###==========================................=..................................................................................=\
=..........###==========================................=..................................................................................=\
=..........###==========================...............=...................................................................................=\
=..........###==========================..............=....................................................................................=\
=.........###==========================...............=....................................................................................=\
=.........###==========================..............=.....................................................................................=\
=.........###==========================.............=......................................................................................=\
=.........###==========================...........==.......................................................................................=\
=.........###=========================...........=.........................................................................................=\
=.........###========================..........==..........................................................................................=\
==========###===============================================================================================================================\
