############################################################################################################################################\
#..........................................................................................................................................#\
#..........................................................................................................................................#\
#..........................................................................................................................................#\
#..........................................................................................................................................#\
#..........................................................................................................................................#\
#..........................................................................................................................................#\
#..........................................................................................................................................#\
#..........................................................................................................................................#\
#..........................................................................................................................................#\
#..........................................................................................................................................#\
#..........................................................................................................................................#\
#..........................................................................................................................................#\
#..........................................................................................................................................#\
#..........................................................................................................................................#\
#..........................................................................................................................................#\
#............................##.##.........................................................................................................#\
#............................#...#.........................................................................................................#\
#............................#...#.........................................................................................................#\
#...........................##...#.........................................................................................................#\
#..................#.#......###.##.........................................................................................................#\
#..................#.#......##...#.........................................................................................................#\
#...###########....#.#......##...#.........................................................................................................#\
#...#.........######.#########...#.........................................................................................................#\
#...#.........#...#...#...#...#.##.........................................................................................................#\
#...#............................#.........................................................................................................#\
#...#............................#.........................................................................................................#\
#...#............................#.........................................................................................................#\
#...#.........#...#...#...#...#.##.........................................................................................................#\
#...#.........################...#.........................................................................................................#\
#...###########.............##...#.........................................................................................................#\
#...........................##...#.........................................................................................................#\
#...........................###.##.........................................................................................................#\
#...........................##...#.........................................................................................................#\
#...........................##...#.........................................................................................................#\
#............................#...#.........................................................................................................#\
#............................##.##.........................................................................................................#\
#..........................................................................................................................................#\
#..........................................................................................................................................#\
#..........................................................................................................................................#\
#..........................................................................................................................................#\
#..........................................................................................................................................#\
#..........................................................................................................................................#\
#..........................................................................................................................................#\
#..........................................................................................................................................#\
#..........................................................................................................................................#\
#..........................................................................................................................................#\
#..........................................................................................................................................#\
#..........................................................................................................................................#\
#..........................................................................................................................................#\
#..........................................................................................................................................#\
#..........................................................................................................................................#\
#..........................................................................................................................................#\
#..........................................................................................................................................#\
#..........................................................................................................................................#\
#..........................................................................................................................................#\
#..........................................................................................................................................#\
#..........................................................................................................................................#\
#..........................................................................................................................................#\
############################################################################################################################################\
