==========###===============================================================================================================================\
=.........####=========================.......===..................................................===....===....===....===....===....===..=\
=.........###==========================..........=..............................................===###====###====###====###====###====###===\
=.........###==========================...........==...........................................=############################################\
=.........####=========================.............=.........................................=####...####...####...####...####...####...###\
=.........###==========================..............=........................................=##..........................................=\
=.........###===========================..............=.......................................=##..........................................=\
=..........####=========================..............=......................................=##...........................................=\
=..........###==========================...............=.....................................=##...........................................=\
=..........###==========================................=....................................=##...........................................=\
=..........####==========================...............=.....................................=##..........................................=\
=..........###===========================...............=.....................................=##..........................................=\
=..........###===========================................=....................................=##..........................................=\
=..........####==========================................=....................................=##..........................................=\
=..........###===========================................=...................................=##...........................................=\
=..........###===========================.................=..................................=##...........................................=\
=..........####==========================.................=..................................=##...........................................=\
=..........###===========================.................=...................................=##..........................................=\
=..........###===========================.................=...................................=##......=.....=.............................=\
=..........###===========================..................=..................................=##.......#####..............................=\
=..........##################============..................=..................................=##.......#####..............................=\
=..........#################=============..................=.................................=##........#####..............................=\
=..........#################=============..................=.................................=##........#####..............................=\
=..........###...........####============...................=................................=##........#####..............................=\
=..........###...........###=============...................=.................................=##......=.....=.................=...=.......=\
=..........###...........###=============...................=.................................=##...............................###........=\
=..........###...........####===========....................=.................................=##...............................###........=\
=...........#.............#.============....................=.................................=##...............................###........=\
............#.............#.................................=...................................=..............................=...=.......=\
............#.............#.................................=...................................=..........................................=\
............#.............#.................................=...................................=..........................................=\
............#.............#.................................=...................................=..........................................=\
............#.............#.................................=...................................=..........................................=\
=...........#.............#.============....................=.................................=##..........................................=\
=..........###...........####===========....................=.................................=##..........................................=\
=..........###...........###=============...................=.................................=##..........................................=\
=..........###...........###=============...................=.................................=##..........................................=\
=..........###...........####============..................=.................................=##...........................................=\
=..........#################=============..................=.................................=##...........................................=\
=..........#################=============..................=.................................=##...........................................=\
=..........##################============..................=..................................=##..........................................=\
=..........###===========================.................=...................................=##..........................................=\
=..........###===========================.................=...................................=##..........................................=\
=..........####==========================.................=...................................=##..........................................=\
=..........###===========================.................=..................................=##...........................................=\
=..........###===========================................=...................................=##...........................................=\
=..........####==========================................=...................................=##...........................................=\
=..........###===========================................=....................................=##..........................................=\
=..........###===========================...............=.....................................=##..........................................=\
=..........####=========================................=.....................................=##..........................................=\
=..........###==========================................=.....................................=##..........................................=\
=..........###==========================...............=.....................................=##...........................................=\
=..........####=========================..............=......................................=##...........................................=\
=.........###==========================...............=......................................=##...........................................=\
=.........###==========================..............=........................................=##..........................................=\
=.........####=========================.............=.........................................=##..........................................=\
=.........###==========================...........==..........................................=####...####...####...####...####...####...###\
=.........###=========================...........=.............................................=############################################\
=.........####=======================.........===...............................................===###====###====###====###====###====###===\
==========###===============================================================================================================================\
