==========###===============================================================================================================================\
=.........###..............................................................................................................................=\
=.........###..............................................................................................................................=\
=.........###..............................................................................................................................=\
=.........###..............................................................................................................................=\
=.........###..............................................................................................................................=\
=.........###..............................................................................................................................=\
=..........###.............................................................................................................................=\
=..........###.............................................................................................................................=\
=..........###.............................................................................................................................=\
=..........###.............................................................................................................................=\
=..........###.............................................................................................................................=\
=..........###.............................................................................................................................=\
=..........###.............................................................................................................................=\
=..........###.............................................................................................................................=\
=..........###.............................................................................................................................=\
=..........###.............................................................................................................................=\
=..........###.............................................................................................................................=\
=..........###.............................................................................................................................=\
=..........###.............................................................................................................................=\
=..........#################...............................................................................................................=\
=..........#################...............................................................................................................=\
=..........#################...............................................................................................................=\
=..........###...........###...............................................................................................................=\
=..........###...........###...............................................................................................................=\
=..........###...........###...............................................................................................................=\
=..........###...........###...............................................................................................................=\
=...........#.............#................................................................................................................=\
............#.............#................................................................................................................=\
............#.............#................................................................................................................=\
............#.............#................................................................................................................=\
............#.............#................................................................................................................=\
............#.............#................................................................................................................=\
=...........#.............#................................................................................................................=\
=..........###...........###...............................................................................................................=\
=..........###...........###...............................................................................................................=\
=..........###...........###...............................................................................................................=\
=..........###...........###...............................................................................................................=\
=..........#################...............................................................................................................=\
=..........#################...............................................................................................................=\
=..........#################...............................................................................................................=\
=..........###.............................................................................................................................=\
=..........###.............................................................................................................................=\
=..........###.............................................................................................................................=\
=..........###.............................................................................................................................=\
=..........###.............................................................................................................................=\
=..........###.............................................................................................................................=\
=..........###.............................................................................................................................=\
=..........###.............................................................................................................................=\
=..........###.............................................................................................................................=\
=..........###.............................................................................................................................=\
=..........###.............................................................................................................................=\
=..........###.............................................................................................................................=\
=.........###..............................................................................................................................=\
=.........###..............................................................................................................................=\
=.........###..............................................................................................................................=\
=.........###..............................................................................................................................=\
=.........###..............................................................................................................................=\
=.........###..............................................................................................................................=\
==========###===============================================================================================================================\
