############################################################################################################################################\
####...#.########..#####..###############....##########...###...#########.###..####....#######..##....##################..#.#.######.#.#.###\
##.#.....#...###....###....##########..##.....#######.......#....########......####....##..#....#......################.....#.######.#...###\
##...........#.......##....##.#####...............##...........................#........#................#######...####...........#.......##\
#..........................##.#.##.................#......................................................##.###....#......................#\
#..........................#..#............................................................................#..##...........................#\
##.........................................................................................................#..............................##\
##........................................................................................................................................##\
###.......................................................................................................................................##\
##.......................................................................................................................................###\
#........................................................................................................................................###\
#.........................................................................................................................................##\
#.......................................................................................................................................####\
##.....................................................................................................................................#####\
##.....................................................................................................................................#####\
####...................................................................................................................................#####\
###.....................................................................................................................................####\
###.....................................................................................................................................####\
##........................................................................................................................................##\
##........................................................................................................................................##\
##.........................................................................................................................................#\
##...###############.....................................................................................................................###\
###..#.............#.....................................................................................................................###\
##...#.............#.....................................................................................................................###\
#....#.............###....................................................................................................................##\
###..#...............#....................................................................................................................##\
###..#...............+.....................................................................................................................#\
###..#...............#..................................................................................................................####\
#....#.............###..................................................................................................................####\
#....#.............#...................................................................................................................#####\
#....#.............#...................................................................................................................#####\
#....#.............#....................................................................................................................####\
##...###############....................................................................................................................####\
##.....................................................................................................................................#####\
###.....................................................................................................................................####\
###.....................................................................................................................................####\
###......................................................................................................................................###\
###......................................................................................................................................###\
##........................................................................................................................................##\
##........................................................................................................................................##\
#####...................................................................................................................................####\
#####..................................................................................................................................#####\
#####.....................................................................................................................................##\
#####......................................................................................................................................#\
#####......................................................................................................................................#\
#####......................................................................................................................................#\
#####......................................................................................................................................#\
#####.....................................................................................................................................##\
#####....................................................................................................................................###\
#####....................................................................................................................................###\
#####....................................................................................................................................###\
#####...................................................................................................................................####\
#####....................................................................................................................#..............####\
#####...................................................................................................................###............#####\
#######################################################################################################................####...............##\
#######################################################################################################..............#######.........##....#\
#######################################################################################################..............#######........###.####\
##########################################################################################################..###......#########......########\
###########################################################################################################.####....###########....#########\
############################################################################################################################################\
