############################################################################################################################################\
############################################################################################################################################\
############################################################################################################################################\
############################################################################################################################################\
############################################################################################################################################\
############################################################################################################################################\
###########################################################...###############...############################################################\
###########################################################...###############...############################################################\
###########################################################...###############...############################################################\
############################################################+#################+#############################################################\
############################################################.#######...#######.#############################################################\
############################################################..######...######..#############################################################\
############################################################...#####...#####...#############################################################\
#############################################################..######+######..##############################################################\
#############################################################...#####.#####...##############################################################\
#############################################################....####.####....##############################################################\
#############################################################.....###.###.....##############################################################\
##############################################################.....##+##.....###############################################################\
##############################################################...............###############################################################\
##############################################################...............###############################################################\
##############################################################...............###############################################################\
##############################################################...............###############################################################\
#############################################################.................##############################################################\
############################################################...................#############################################################\
############################################...############.....................############...#############################################\
############################################...+...........................................+...#############################################\
############################################...###.......................................###...#############################################\
####################################################...................................#####################################################\
######################################################...............................#######################################################\
########################################################...........................#########################################################\
##########################################################.......................###########################################################\
##########################################################.......................###########################################################\
##########################################################.......................###########################################################\
###########################################################.....................############################################################\
##########################################################.......................###########################################################\
##########################################################.......................###########################################################\
#########################################################.........................##########################################################\
########################################################...........................#########################################################\
#######################################################.............................########################################################\
######################################################.......###...........###.......#######################################################\
#####################################################......#######.......#######......######################################################\
#####################################################....##########.....##########....######################################################\
###############################################...##...############.....############...##...################################################\
###############################################...+..##############.....##############..+...################################################\
###############################################...#################.....#################...################################################\
####################################################################...#####################################################################\
####################################################################...#####################################################################\
####################################################################...#####################################################################\
####################################################################...#####################################################################\
####################################################################...#####################################################################\
#####################################################################.######################################################################\
#####################################################################.######################################################################\
#####################################################################.######################################################################\
#####################################################################+######################################################################\
####################################################################...#####################################################################\
####################################################################...#####################################################################\
####################################################################...#####################################################################\
############################################################################################################################################\
############################################################################################################################################\
############################################################################################################################################\
