############################################################################################################################################\
####...#.########..#####..###############....##########...###...############################################################################\
##.#.....#...###....###....##########..##.....#######.......#....###########################################################################\
##...........#.......##....##.#####...............##.........................###############################################################\
#..........................##.#.##.................#........................################################################################\
#..........................#..#...........................................................................................##################\
##........................................................................................................................##################\
##........................................................................................................................##################\
###.......................................................................................................................##################\
##........................................................................................................................##################\
#.........................................................................................................................##################\
#.........................................................................................................................##################\
#.........................................................................................................................##################\
##.....................#####################################################################################################################\
##.....................................................................................................#####################################\
####...................................................................................................#####################################\
###....................................................................................................#####################################\
###....................................................................................................#####################################\
##.....................................................................................................#####################################\
##.....................................................................................................#####################################\
##.....................................................................................................#####################################\
##...###############...................................................................................#####################################\
###..#.............#...................................................................................#####################################\
##...#.............#...................................................................................#####################################\
#....#.............###.................................................................................#####################################\
###..#...............#.................................................................................#####################################\
###..#...............+.................................................................................#####################################\
###..#...............#.................................................................................#####################################\
#....#.............#...................................................................................#####################################\
#....#.............#...................................................................................#####################################\
#....#.............#...................................................................................#####################################\
#....#.............#...................................................................................#####################################\
##...###############...................................................................................#####################################\
##.....................................................................................................#####################################\
###....................................................................................................#####################################\
###....................................................................................................#####################################\
###....................................................................................................#####################################\
###....................................................................................................#####################################\
##.....................................................................................................#####################################\
##.....................................................................................................#####################################\
############################################################################################################################################\
############################################################################################################################################\
############################################################################################################################################\
############################################################################################################################################\
############################################################################################################################################\
############################################################################################################################################\
############################################################################################################################################\
############################################################################################################################################\
############################################################################################################################################\
############################################################################################################################################\
############################################################################################################################################\
############################################################################################################################################\
############################################################################################################################################\
############################################################################################################################################\
############################################################################################################################################\
############################################################################################################################################\
############################################################################################################################################\
############################################################################################################################################\
############################################################################################################################################\
############################################################################################################################################\
