############################################################################################################################################\
#######################################################################################################################.........############\
#######################################################################################################################.............########\
#######################################################################################################################.........###.########\
###################################################################################################################################.########\
###################################################################################################################################.########\
###############################################################################################..#................#.................########\
###############################################################################################.####..########.####.#################......#\
#######################################################################................########.##.#..#......#...##.#......#.#######..####.#\
#######################################################################..#####..#####..########.##.#..########.####.########......##.#####.#\
#######################################################################..#..........#..########.##.#..#...........#..........####.##.#####.#\
#######################################################################..#..........#..########.##.#..#.###########.########.#....##.#####.#\
#######################.......................................#########..############..########.##.#..#.#......#...........#.#.....#..####.#\
#######################.......................................#########................########.##.####.#.##.#.##########..#.#.###########.#\
#######################.......................................#########................########.##......#..#.#.#........#..#.#..#...######.#\
#######################.......................................################..###############.##.#########.#.#.#.####.#..#.######......#.#\
#######################.......................................################..###############.##.#.........#.#.#.#..#.#..#....#.#.####.#.#\
#######################.......................................################..###############.##.#.......#.#.#.#.#..#.#######.#.#.####.#.#\
#######################.......................................################..###############.##.#########.###.#.#..........#.#.#.####.#.#\
#######################.......................................################..###############.##...............#.#####.###..#.#.#.####.#.#\
#######################.......................................#########................########.##.#########.###.#.....#.######.###.####.#.#\
#######################.......................................#########..#..........#..########.##.######......#.#.###.#.#......#...####.#.#\
#######################.......................................#########................########.##.............#.#...###.#.######.######.#.#\
#######################.......................................#########.......##.......########.##.###########.#.###.#.###.######....###.#.#\
#######################.......................................................##................##.#######...#.#.##..#.....#....#.#..###.#.#\
#######################..................................................................................#...#.#.##.##.###.####.#.#..###.#.#\
#######################.......................................#########................########.########.#...#.#.#...#..##.#..#.#.######.#.#\
#######################.......................................#########..#..........#..########.########.#######.#.###.###.#..#.#....###.#.#\
#######################.......................................#########................########........#.........#.#...###.#....#.######.#.#\
#######################.......................................#########................########.######.#.......#.#.#...#...#..#.#.#..###.#.#\
#######################.......................................################..###############.##.....#.#####.#.#.###.########.###..###.#.#\
#######################.......................................################..########################.#...#.#.#...#...#.#..#.#.#..###.#.#\
#######################.......................................################...........................#...#.#.#.###.###.#..#.#.#..###.#.#\
#######################.......................................################..########################.#...#.#.#...#.#...##.#.#.#..###.#.#\
#######################.......................................################..#############..........#.#...#.#.#..##.###....#.#.#..###.#.#\
#######################.......................................#########................######.#.###.#..#.#.###.#.#####...#.#..#.#.##.###.#.#\
#######################.......................................#########................######.#...#.#..###.....#.#...#...#.####....#.###.#.#\
#######################.......................................#########................##.....#.###.####.#.#####.#.#.#...#......##.#.###.#.#\
#######################.......................................#########................##.#####.#........#.....#.#.#.#...#.####.##.#.###.#.#\
#######################.......................................#########................##.#####.#.######.#######.#.#.#.###.#.##.##.#.###.#.#\
#######################################################################................##.#####.#.#..............#.#.#.....#.##.##.#.###.#.#\
#######################################################################................##.#####.#.#..#############.#.#.#####.##.##.#.###.#.#\
##########################################################............###################.#####.#.#..###############.#.#........##...###.#.#\
##########################################################.######.####.#####.############.#####.###..................#.#.######.##...###...#\
##########################################################.######.####.#####..............#####.#.########################.####.########.###\
##########################################################.#......####.......#####.########.....#.########################.####.########.###\
##########################################################.#.####.##############.........##.###.#............................##.###......###\
##########################################################.#.##......###########.#######.##.#####.#############.##########.####.###.####.###\
##########################################################.#.####.##.###########.#######.##....##.#.............##............#.###.##.#.###\
##########################################################.#......##.............#######.#####....#.###.####.#####.##.####.####.###....#.###\
##########################################################.###.#####.###########.#######.#####.##.#####.##########.############.########.###\
##########################################################.###.......###########.#############.##...............#...............########.###\
##########################################################.#####################.#############.#########################################.###\
##########################################################.......................#..............................#........................###\
###########################################################################################.###################.####.#######################\
###########################################################################################.###################.####.#######################\
###########################################################################################......##############.####.#######################\
###############################################################################################################......#######################\
############################################################################################################################################\
############################################################################################################################################\
