==========###=========================...===================================================================================================\
=.........###==========================.......................................==...........................................................=\
=.........###==========================.........................................=..........................................................=\
=.........###==========================..........................................==........................................................=\
=.........###==========================............................................=.......................................................=\
=.........###==========================.............................................=......................................................=\
=.........###===========================.............................................=.....................................................=\
=..........###==========================.............................................=.....................................................=\
=..........###==========================..............................................=....................................................=\
=..........###==========================...............................................=...................................................=\
=..........###===========================..............................................=...................................................=\
=..........###===========================..............................................=...................................................=\
=..........###===========================...............................................=..................................................=\
=..........###===========================...............................................=..................................................=\
=..........###===========================...............................................=..................................................=\
=..........###===========================................................................=.................................................=\
=..........###===========================................................................=.................................................=\
=..........###===========================................................................=.................................................=\
=..........###===========================................................................=.................................................=\
=..........###===========================.................................................=................................................=\
=..........#################=============.................................................=................................................=\
=..........#################=============.................................................=................................................=\
=..........#################=============.................................................=................................................=\
=..........###...........###=============..................................................=...............................................=\
=..........###...........###=============..................................................=...............................................=\
=..........###...........###=============..................................................=...............................................=\
=..........###...........###============...................................................=...............................................=\
=...........#.............#.============...................................................=...............................................=\
............#.............#................................................................................................................=\
............#.............#................................................................................................................=\
............#.............#................................................................................................................=\
............#.............#................................................................................................................=\
............#.............#................................................................................................................=\
=...........#.............#.============...................................................=...............................................=\
=..........###...........###============...................................................=...............................................=\
=..........###...........###=============..................................................=...............................................=\
=..........###...........###=============..................................................=...............................................=\
=..........###...........###=============..................................................=...............................................=\
=..........#################=============.................................................=................................................=\
=..........#################=============.................................................=................................................=\
=..........#################=============.................................................=................................................=\
=..........###===========================.................................................=................................................=\
=..........###===========================................................................=.................................................=\
=..........###===========================................................................=.................................................=\
=..........###===========================................................................=.................................................=\
=..........###===========================................................................=.................................................=\
=..........###===========================...............................................=..................................................=\
=..........###===========================...............................................=..................................................=\
=..........###===========================...............................................=..................................................=\
=..........###==========================...............................................=...................................................=\
=..........###==========================...............................................=...................................................=\
=..........###==========================...............................................=...................................................=\
=..........###==========================..............................................=....................................................=\
=.........###==========================..............................................=.....................................................=\
=.........###==========================..............................................=.....................................................=\
=.........###==========================.............................................=......................................................=\
=.........###==========================............................................=.......................................................=\
=.........###=========================...........................................==........................................................=\
=.........###========================...........................................=..........................................................=\
==========###========================....===================================================================================================\
