==========####==============================================================================================================================\
=.........###==========================....======..................................................===....===....===....===....===....===..=\
=.........###==========================.......====..............................................===###====###====###====###====###====###===\
=.........####=========================..........===...........................................=############################################\
=.........###==========================...........===.........................................=####...####...####...####...####...####...###\
=.........###==========================.............==........................................=##..........................................=\
=.........#####=========================.............==.......................................=##..........................................=\
=..........###==========================.............==......................................=##...........................................=\
=..........###==========================..............==.....................................=##...........................................=\
=..........####=========================...............==....................................=##...........................................=\
=..........###===========================..............==.....................................=##..........................................=\
=..........###===========================..............==.....................................=##..........................................=\
=..........####==========================...............==....................................=##.........=.........=......................=\
=..........###===========================...............==....................................=##..........#########.......................=\
=..........###===========================...............==...................................=##...........#########.......................=\
=..........####==========================................==..................................=##...........#########.......................=\
=..........###===========================................==..................................=##..........=.........=......=...=...........=\
=..........###===========================................==...................................=##...........................###............=\
=..........####==========================................==...................................=##......=.....=..............###............=\
=..........#####==#==#==#==#=============.................==..................................=##.......#####...............###............=\
=..........##################============.................==..................................=##.......#####..............=...=...........=\
=..........#################=============.................==.................................=##........#####..............................=\
=..........#################=============.................==.................................=##........#####..........=...=...............=\
=..........###....=.==...####============..................==................................=##........#####...........###................=\
=..........###...........###=============..................==.................................=##......=.....=..........###....=...=.......=\
=..........###.........==###=============..................==.................................=##.......................###.....###........=\
=..........###.=.........####===========...................==.................................=##......................=...=....###........=\
=...........#.............#.============...................==.................................=##...............................###........=\
............#.............#................................==...................................=..............................=...=.......=\
............#.............#................................==...................................=..........................................=\
............#.............#................................==...................................=..........................................=\
............#.............#................................==...................................=..........................................=\
............#.............#................................==...................................=..........................................=\
=...........#.............#.============...................==.................................=##..........................................=\
=..........###.....=.=.=.####===========...................==.................................=##..........................................=\
=..........###......===..###=============..................==.................................=##..........................................=\
=..........###.....=.=.=.###=============..................==.................................=##..........................................=\
=..........###...........####============.................==.................................=##...........................................=\
=..........#################=============.................==.................................=##...........................................=\
=..........#################=============.................==.................................=##...........................................=\
=..........##################============.................==..................................=##..........................................=\
=..........#####==#==#==#==#=============................==...................................=##..........................................=\
=..........####==========================................==...................................=##..........................................=\
=..........###===========================................==...................................=##..........................................=\
=..........###===========================................==..................................=##...........................................=\
=..........####==========================...............==...................................=##...........................................=\
=..........###===========================...............==...................................=##...........................................=\
=..........###===========================...............==....................................=##..........................................=\
=..........####==========================..............==.....................................=##..........................................=\
=..........###==========================...............==.....................................=##..........................................=\
=..........###==========================...............==.....................................=##..........................................=\
=..........####=========================..............==.....................................=##...........................................=\
=..........###==========================.............==......................................=##...........................................=\
=.........####=========================..............==......................................=##...........................................=\
=.........#####========================.............==........................................=##..........................................=\
=.........###==========================...........===.........................................=##..........................................=\
=.........###==========================..........===..........................................=####...####...####...####...####...####...###\
=.........####========================........====.............................................=############################################\
=.........###========================......======...............................................===###====###====###====###====###====###===\
==========###===============================================================================================================================\
